# Dark Ally
=background [DarkAlly]
=sound [DarkAlly]
=bot1 Mage
=bot2 Mage
=bot3 Mage
=bot4 Thief
=snode 9,6
=snode 32,6
=snode 20,4
=snode 4,14

........................................
..............============..............
..........====............====..........
........==.........2..........==........
......==..............+.........==......
.....=..1......................3..=.....
....=..............................=....
...=................................=...
..=..................+...............=..
.=..+............@..@.................=.
.=.......+.............@..............=.
=.............+....@+..................=
=...............@.+..@..............*..=
=..4..............@..+.@...............=
=..................+@....+.............=
.=..............@.............+.......=.
.=.................@..@............+..=.
..=...............+..................=..
...=................................=...
....=...*......................*...=....
.....==..........................==.....
.......==........+.............==.......
.........=..........*.........=.........
..........====............====..........
..............============..............
