# Solanian Castle
=background [Solania]
=bot1 Pikeman
=bot2 Pikeman
=bot3 Pikeman
=bot4 Lancer
=sound [Solania]

...........#.A............A.#...........
...........#.P............P.#...........
...........#O+............+O#...........
...........#OP............PO#...........
............#.P+P+P++P+P+P.#............
............#..............#............
...........#.55.66.77.88.99.#...........
...........#................#...........
..........#A.O..O..OO..O..O.A#..........
..........#O+#++#++##++#++#+O#..........
.........#A..................A#.........
.........#...#...+....+...#...#.........
........#.1111....2222....3333.#........
........#.1111...+2222+...3333.#........
........#......................#........
........#......................#........
........#.#+#+#+#......#+#+#+#.#........
........#.+PPPP+........+PPPP+.#........
........#.#PAP#..........#PAP#.#........
........#.+PP#+..........+#PP+.#........
........#.#O#P+..........+P#O#.#........
........#.+#++............++#+.#........
........#.#A#..............#A#.#........
.......#AP+#+.#..........#.+#+PA#.......
......#AAAP#P#....4..4....#P#PAAA#......
