# Arena Battlefield
# Author: Autrijus Tang
........................................
........................................
........................................
........................................
.....+############################+.....
.....#@..........................@#.....
.....#.#.##............O.....####.#.....
.....#.#..........A...............#.....
.....#.#.....O.......P..........#.#.....
.....#.#...................O....#.#.....
.....#...........++++++...........#.....
.....#...........+P..P+...........#.....
.....#..A....P...+.AA.+........A..#.....
.....#...........+P..P+...P..O....#.....
.....#...........++++++...........#.....
.....#.#...O....................#.#.....
.....#.#.........P.......O......#.#.....
.....#..........................#.#.....
.....#.####.....O..A.........##.#.#.....
.....#@..........................@#.....
.....+############################+.....
........................................
........................................
........................................
........................................
