# Coccon's Heaven

........................................
........................................
........................................
........................................
.....+############################+.....
.....#...........#....#...........#.....
.....#........OOO#..@.#OOO........#.....
.....#........OOO#....#OOO........#.....
.....#........OOO#++++#OOO........#.....
.....############@.....############.....
.....#..........+......+..........#.....
.....#.@........+......+.@........#.....
.....#........@.+..1...+........@.#.....
.....#..........+......+..........#.....
.....############.....@############.....
.....#........OOO#++++#OOO........#.....
.....#........OOO#....#OOO........#.....
.....#........OOO#.@..#OOO........#.....
.....#...........#....#...........#.....
.....+############################+.....
........................................
........................................
........................................
........................................
........................................