O.......................................
........................................
O..#####.#######.#####.###..............
........................................
.....++++.+++++++.++++..++++.+++........
........................................
........*******....**********.****......
O.......................................
..........P.......P.........P.....P.....
O.......................................
........................................
....P....................O..............
.........O...P..........................
.....................A.............P....
................O.........O.............
.......O.........................O......
...........TTTTT...........@.........@..
.....P................PPP...............
......................P.P......TTTTTTT..
......................PPP...............
........++++++++++++..++++..............
.*..*****...............................
..............#####.################....
........................................
........................................
