# Duel of Power

........................................
........AAAAAAAAAAA#AAAAAAAAAAA.........
........AA#########A#########AA.........
........A#AA...PP.AAA.PP...AA#A.........
........A#A....PP.....PP....A#A.........
........A#..@..PP..@..PP..@..#A.........
........A#.....PP.....PP.....#A.........
........A#....APP.....PPA....#A.........
........A#PPPPPPPPPPPPPPPPPPP#A.........
........A#PPPPPPPPPPPPPPPPPPP#A.........
........A#.....PPA...APP.....#A.........
........A#A....PP.....PP....A#A.........
........#AA.@..PP..@..PP..@.AA#.........
........A#A....PP.....PP....A#A.........
........A#.....PPA...APP.....#A.........
........A#PPPPPPPPPPPPPPPPPPP#A.........
........A#PPPPPPPPPPPPPPPPPPP#A.........
........A#....APP.....PPA....#A.........
........A#.....PP.....PP.....#A.........
........A#..@..PP..@..PP..@..#A.........
........A#A....PP.....PP....A#A.........
........A#AA...PP.AAA.PP...AA#A.........
........AA#########A#########AA.........
........AAAAAAAAAAA#AAAAAAAAAAA.........
........................................
