# The Great Fire

........................................
........................................
........................................
........................................
........................................
............################............
............#OOAA..PP..AAOO#............
............#O++OOOOOOOO++O#............
............#A+AA..PP.@AA+A#............
............#AOA++OOOO++AOA#............
............#.O@+A...@A+.O.#............
............#.O.O@.PO..O.O.#............
............#POPO.OAAP.OPOP#............
............#POPO.P@AO.OPOP#............
............#.O.O..OP.@O.O.#............
............#.O.+A@...A+@O.#............
............#AOA++OOOO++AOA#............
............#A+AA@.PP..AA+A#............
............#O++OOOOOOOO++O#............
............#OOAA..PP..AAOO#............
............################............
........................................
........................................
........................................
........................................
