# Dangerous hall

........................................
...##################################...
.....#.@.......+OAAPPAAO+.........#.....
.....#.O.......+OAAPPAAO+@......O.#.....
.....#...++....+++OPPO+++....++...#.....
.....#...++......++++++......++...#.....
.....#.......O.O........O.O.......#.....
.....#...@...A.A........A.A.......#.....
.....#...++...P.@..*.....P..@++...#.....
.....#...++...P..........P...++...#.....
.....#.......A.A........A.A.......#.....
.....#.......O.O....@...O.O.......#.....
.....#.......A.A........A.A.......#.....
.....#...++...P..........P...++...#.....
.....#...++@..P..........P...++...#.....
.....#.......A.A........A.A.......#.....
.....#.......A.A........A.A.......#.....
.....#...++...P..........P..@++...#.....
.....#...++...P...O..O...P...++...#.....
######O............@.............O######
AAAAA#############++++#############AAAAA
PPPPPPPPPPPPPPPPPOPPPPOPPPPPPPPPPPPPPPPP
