# Open Ground

........................................
........................................
........................................
........................................
........................................
....################################....
....#..............................#....
....#..............................#....
....#..*...........................#....
....#..............................#....
....#..............................#....
....#..............................#....
....#..............................#....
....#.........@.............@......#....
....#..............................#....
....#..............*...............#....
....#..............................#....
....#..............................#....
....#..............................#....
....################################....
........................................
........................................
........................................
........................................
........................................