#..........................A............
#.....##...........................#....
...............+...+..#.................
........................A............P.#
.....#..................................
.......+.#.......P....#O................
.................#..O+#...#.....#.......
..........P.......##..+.O.....#........+
...#......+...O##......................#
.A......................................
.............A..........................
....+....+....................#.........
.#......................#...............
........#......#............P...........
....#.....A........+.......#............
..##......A.......+..................#..
.....#..........P....#.............+...A
A....................................#..
....A.......................O........+..
......A.......................+.........
.....+....................#.............
..........A.............................
...........#............................
.........................+..............
............#....#....P.................
