# Street
=b#ckground 2

........................................
........................................
........................................
........................................
........................................
..#+#+#+#+#+#+#+#+#+#+#+#+#+#+#+#+#+#+..
..+#A#A#A#A#A#A#A#A#A#A#A#A#A#A#A#A#A#..
..#A.......#.#@.....#.#.#@..........#+..
..+#.#.#.#.#.######.#.#.########.#.#A#..
..#A@#...#............#..........#.@#+..
..+#######.#####.#######.#####.###.#A#..
..#A................................#+..
..+#.##.#####.####.##.####.########.A#..
..#A.....#.#...#@..........#@.......#+..
..+#.#.#.#.#.#.####.#.#.#.##.#####.#A#..
..#A.#.#...#.#..#...#.#.#....#......#+..
..+#.#.#.###.##.#.#.#.#.#.##....#.#.A#..
..#A.#....#@..#.#.#.#.#....#..###.#.#+..
..+#.#.#.####.#.#.#.#.####.#.##@#.#.A#..
..#A...#......#.#.#...#@...#....#...#+..
..+#A#A#A#A#A#A#A#A#A#A#A#A#A#A#A#A#A#..
..#+#+#+#+#+#+#+#+#+#+#+#+#+#+#+#+#+#+..
........................................
........................................
........................................