%..........*...........
.......................
..===================..
..=.....=.....=.....=..
..=.....=.....=.....=..
..=..=..=..=..=..=..=..
..=.....=.....=.....=..
..=.....=..P..=.....=..
..===================..
..=.....=.....=.....=..
*.=.....=..@..=.....=.*
..=..=..=..=..=..=..=..
..=.....=.....=.....=..
..=.....=..P..=.....=..
..===================..
..=.....=.....=.....=..
..=.....=.....=.....=..
..=..=..=..=..=..=..=..
..=.....=.....=.....=..
..=.....=.....=.....=..
..===================..
.......................
...........*..........&
