#P.o.P..*.....=.....#==
##############=######*=
##===#.......==#######=
===.====.....=........=
=##.###=#####=#########
=..=====.....==.....=..
###=..###.....=#####=##
..==.....======.....=..
##=#######.#.#######=##
..=.#...*.###..##...=..
#####===..o#&...####=..
..*..=##.#####.##.#.=##
=###.=#...%#*.=.....=..
=###.=##..###.=#####=..
=###.=.....#..=#..#.=##
=....=..#.....=...#.=..
=##################.###
=...=......=..........=
####=######=##########=
=...=#.*...=.#&...*...=
=######################
=#......#=======#......
=.........*....=......@
