#===#....==============
#&#=P.###=....###.P..#=
###=###========.###...=
#..=#===*###.#====##..=
..#===#=#.....#=#=.##.=
.##==.#=...#..==#===##=
.#==.#==.#####=..#...#=
.#=.#.=.##....====#..#=
.#=.#======.===#..#..#=
===#.=#=.=====.##..#..=
=..#.=#===...==.#..#..=
=....=#.=..#..=.#=....=
=..#..#.==...===#=.#.P=
=P.#..##.=====.=#=.#===
=#..#..#===.======#.=#.
=#..#====....##.=.#.=#.
=#...#..=#####.==#.==#.
=##===#==..#...=#.==##.
=.##.=#=#.....#=#===#..
=..##====#.###*===#=..#
=...###.========###=###
=#...@###....=###..=#%#
==============....#===#
